15 10 5
##########
#      ###
# #### ###
# #    ###
# # ######
# # ######
# # ######
# # ######
# # ######
# #*######
# # ##   #
# #    # #
# ###### #
#        #
##########
15 10 1
##########
#        #
#        #
#        #
#        #
#        #
#        #
#        #
#        #
#        #
#        #
#        #
#        #
#*       #
##########